########
#      #
#  V   #
#      #
#      #
########