###############################
#                             #
#  V                          #
#                             #
#                             #
#                             #
#                             #
#                             #
#                             #############################################################################################
#                                                                                                                         #
#                                                                                                                         #
#                                                                                                                         #
#                                                                                                                         #
#                                                                                                                         #
#                                                                                                                         #
#                                                                                                                         #
#                                                                                                                         #
#       ###################################################################################################################
#       #
#       #
#       #
#       #
#########