###############################
#                             #
#  V                          #
#                             #
#                             #
#                             #
#                             #
#                             #
#                             #
#                             #
#                             #
#                             #
#                             #
#                             #
#                             #
#                             #
#                             #
#       #######################
#       #
#       #
#       #
#       #
#########